5 20
####################
#                  #
E   A  A  A     L  #
#                  #
####################