7 20
####################
#         #        #
#   A     #   L S  #
E         #        #
#         #    S   #
#    K    D        #
####################