5 20
####################
#  K K    #      L #
E  K K    D        #
#         #        #
####################